Check out (v): tr? phòng 
Leisure Center: trung tâm gi?i trí v? m?t th? thao
Heated swimming pool: b? boi nu?c nóng
Outdoor vs Indoor: ngoài tr?i và trong nhà 
Water slides: máng tru?t  nu?c
Lane: làn
Serious: nghiêm tr?ng/nghiêm túc
Available: có s?n/s?n sàng
For all levels: cho m?i c?p d?
Fitness center: trung tâm th? d?c, th? thao
Exercise bikes: xe d?p dùng t?p th? d?c
Weight machines: máy t?p t?
Free weights: t? d?i
Fitness expert: chuyên gia th? thao
Provide one with sth: cung c?p cho ai cái gì 
Fitness program: chuong trình th? d?c th? thao
Suit your needs: phù h?p nhu c?u c?a b?n
Indoor soccer: dá bóng trong nhà
Badminton: c?u lông
Basketball: bóng r?
Sports hall: h?i tru?ng th? thao
Various: da d?ng
Community sports group: nhóm th? thao c?ng d?ng
Sign up for: dang kí
Tournament: gi?i d?u
Book + a place/a service: d?t ch?/d?ch v?
Coming soon: s?m xu?t hi?n
Find out about: tìm ra
Kindergarten: m?u giáo
Discount: gi?m giá
Take advantage of: t?n d?ng
Weekdays: các ngày trong tu?n
Cafeteria (n) : cang tin
Facility: co s? v?t ch?t
Cater: chu c?p
Specific: c? th?
Personal trainer: hu?n luy?n viên th? hình
Original: g?c
Center: trung tâm
Centre: trung tâm
Item = thing: m?i cái, m?i v?t, m?i th?
